wwwwwwwwwwwwwwwwwww
w++++++++++++++o+gw
w+++++++++++++++++w
w+++++++++++++++++w
w+++++++++++++++++w
w+++++++i+++++++++w
w+++++++++++++++++w
w++++++A++++++++++w
w+++++++++++++++++w
w+++++++++++++++++w
wwwwwwwwwwwwwwwwwww
